
GRL = "countries/Greenland.txt" #PA

#Native Tags
UAY = "countries/Uaymil.txt"
ECA = "countries/Ecab.txt"
CKK = "countries/Chikinchel.txt"
TAZ = "countries/Tazes.txt"
CLT = "countries/Calotmul.txt"
AKC = "countries/AhKinChel.txt"
CPE = "countries/CehPech.txt"
CKN = "countries/Chakan.txt"
ACN = "countries/AhCanul.txt"
HKB = "countries/Hokaba.txt"
CPU = "countries/Champutun.txt"
XIC = "countries/Xicallanco.txt"
TIX = "countries/Tixchel.txt"
IXT = "countries/Ixtapa.txt"
DZU = "countries/Dzuliunicob.txt"
MPN = "countries/Mopan.txt"
CEH = "countries/CeHache.txt"
TBC = "countries/TabsCoob.txt"
ZOQ = "countries/Zoque.txt"
COA = "countries/Coatlicamac.txt"
CPA = "countries/Chilapan.txt"
XOC = "countries/Xoconochco.txt"
ZAC = "countries/Zapulcu.txt"
CAZ = "countries/Coatzacoalcos.txt"
CYL = "countries/Coyolapan.txt"
TEZ = "countries/Teozacualco.txt"
TOC = "countries/Tochtepec.txt"
TZU = "countries/Tzul.txt"
